0001107000000000000000000000000000000000000222220000000
2201100700050000000000000000000000000000000200022200000
0200000550555550000000000022222222220000000200000220000
0220000000000000000222222220000000022222002200000022000
0022222000000222222200002000000000000002222000000002000
0000002222222200200000034333333300003333433330000002000
0333333320003333433330034444444300003444444430000002000
0344444422003444444430034444444300003444444430000022000
0344444302203444444430034444444300003444444430000020000
0344444300203444444430033333333300003444444430000020000
0344444300203333333330000000000000003333333330000020000
0344444300200000000000000000000000000000000000000220000
0344444300220000333333333333330003333333333330000200000
0344444300020000344444444444430003444444444430000200000
0344444300020000344444444444430003444444444430000200000
0344444300022000344444444444430003444444444430000200000
0333333300002222333333333333330003444444444430002200000
0000000000000002222222222220000003444444444430002000000
0000000000000002000000000022222223333343333330222000000
0000003333333334300000000000000022200020000022200000000
0000003444444444300000000000000000222222222220000000000
0000003444444444300000000000000000033334333333333000000
0000003444444444300000000000000000034444444444443000000
0000003333333333300000000000000000034444444444443000000
0000000000000000000000000000000000034444444444443000000
0000000000000000000000000000000000034444444444443000000
0000000000000000000000000000000000033333333333333000000
0000000000000000000000000000000000000000000000000000000
0000000000000000000000000000000000000000000000000000000
0000000000000000000000000000000000000000000000000000000