020000000000000
200000000000000
020000000000000
222020020000000
020020000000000
000220000000000
020222222200000
022200000000000
000000000000000
000000000000000
000000000000000
000000000000000
