555555555555555555555555555555555555555555555555555555555555555555555555555555555555555
555555555555555555555555555555555555555555555555555555555555555555555555555555555555555
555555555555000000000000555555555555555555555555555555555555555555555555555555555555555
555555550000000000000000000005555555555555555555555555555555555555555555555555555555555
555550000000000000000000000000000055555555555555555555555555555555555555555555555555555
555550000000000000000000000000000005555555555555555555555555555555555555555555555555555
555550000000000000000000000000000005555555555555555555555555555555555555555555555555555
555550000000000000000000000000000055555555555555555555555555555555555555555555555555555
555555550000000000000000000000055555555555555555555555555555555555555555555555555555555
555555555555550000000000555555555555555555555555555555555555555555555555555555555555555
555555555555555555555555555555555555555555555555555555555555555555555555555555555555555
555555555555555555555555555555555555555555555555555555555555555555555555555555555555555
555555555555555555555555555555555555555555555555555555555555555555555555555555555555555
555555555555555555555555555555555555555555555555555555555555555555555555555555555555555
555555555555555555555555555555555555555555555555555555555555555555555555555555555555555
555555555555555555555555555555555555555555555555555555555555555555555555555555555555555
555555555555555555555555555555555555555555555555555555555555555555555555555555555555555
555555555555555555555555555555555555555555555555555555555555555555555555555555555555555
555555555555555555555555555555555555555555555555555555555555555555555555555555555555555
555555555555555555555555555555555555555555555555555555555555555555555555555555555555555